NO /Users/fbohling/Desktop/cub3d/textures/bricksx64.xpm
SO /Users/fbohling/Desktop/cub3d/textures/bricksx64.xpm
EA /Users/fbohling/Desktop/cub3d/textures/bricksx64.xpm
WE /Users/fbohling/Desktop/cub3d/textures/bricksx64.xpm
C 177, 184, 84
F 114, 117, 75




111111111111
100000000001
100000000001
100000000001
111110N011111
    11111
